"filename", "language", "Java", "comment", "blank", "total"
"h:\Code\ZJH Programming Files\STS - Test1\AcidSlimeLarge.java", "Java", 76, 1, 9, 86
"h:\Code\ZJH Programming Files\STS - Test1\AcidSlimeMed.java", "Java", 62, 1, 7, 70
"h:\Code\ZJH Programming Files\STS - Test1\AcidSlimeSmall.java", "Java", 32, 2, 7, 41
"h:\Code\ZJH Programming Files\STS - Test1\BlueSlaver.java", "Java", 44, 1, 7, 52
"h:\Code\ZJH Programming Files\STS - Test1\Card.java", "Java", 90, 16, 17, 123
"h:\Code\ZJH Programming Files\STS - Test1\Colors.java", "Java", 88, 8, 8, 104
"h:\Code\ZJH Programming Files\STS - Test1\Combat.java", "Java", 666, 87, 71, 824
"h:\Code\ZJH Programming Files\STS - Test1\Cultist.java", "Java", 23, 1, 7, 31
"h:\Code\ZJH Programming Files\STS - Test1\Enemy.java", "Java", 86, 9, 13, 108
"h:\Code\ZJH Programming Files\STS - Test1\Entity.java", "Java", 385, 60, 29, 474
"h:\Code\ZJH Programming Files\STS - Test1\FatGremlin.java", "Java", 20, 1, 7, 28
"h:\Code\ZJH Programming Files\STS - Test1\FungiBeast.java", "Java", 41, 1, 7, 49
"h:\Code\ZJH Programming Files\STS - Test1\GreenLouse.java", "Java", 49, 1, 7, 57
"h:\Code\ZJH Programming Files\STS - Test1\GremlinWizard.java", "Java", 28, 3, 7, 38
"h:\Code\ZJH Programming Files\STS - Test1\Intent.java", "Java", 153, 5, 4, 162
"h:\Code\ZJH Programming Files\STS - Test1\IntentType.java", "Java", 11, 0, 0, 11
"h:\Code\ZJH Programming Files\STS - Test1\JawWorm.java", "Java", 52, 2, 7, 61
"h:\Code\ZJH Programming Files\STS - Test1\Looter.java", "Java", 73, 1, 12, 86
"h:\Code\ZJH Programming Files\STS - Test1\MadGremlin.java", "Java", 20, 1, 7, 28
"h:\Code\ZJH Programming Files\STS - Test1\Main.java", "Java", 59, 15, 21, 95
"h:\Code\ZJH Programming Files\STS - Test1\RedLouse.java", "Java", 49, 1, 7, 57
"h:\Code\ZJH Programming Files\STS - Test1\RedSlaver.java", "Java", 69, 5, 10, 84
"h:\Code\ZJH Programming Files\STS - Test1\Run.java", "Java", 469, 92, 47, 608
"h:\Code\ZJH Programming Files\STS - Test1\ShieldGremlin.java", "Java", 43, 1, 11, 55
"h:\Code\ZJH Programming Files\STS - Test1\SneakyGremlin.java", "Java", 19, 1, 7, 27
"h:\Code\ZJH Programming Files\STS - Test1\SpikeSlimeLarge.java", "Java", 67, 1, 9, 77
"h:\Code\ZJH Programming Files\STS - Test1\SpikeSlimeMed.java", "Java", 53, 1, 8, 62
"h:\Code\ZJH Programming Files\STS - Test1\SpikeSlimeSmall.java", "Java", 19, 1, 7, 27
"h:\Code\ZJH Programming Files\STS - Test1\Status.java", "Java", 78, 6, 5, 89
"h:\Code\ZJH Programming Files\STS - Test1\Statuses.java", "Java", 39, 2, 5, 46
"Total", "-", 2963, 327, 370, 3660